//////////////////////////////////////////////////////////////////////
/..................................................................../
/..................................................................../
/.........................................................###########/
/.........................................................#........../
/..............................................#####.....#.........../
/.............................................#.....#...#............/
/............................................#.......###............./
/...........................................#........###............./
/............................................#.......###............./
/.............................................#.....#..##............/
/..............................................#####...###.........../
/......................................................####........../
/.............................................#############........../
/.............................................#....................../
/.........................................@...>....................../
/.............................................#....................../
/.............................................#############........../
/......................................................####........../
/..............................................#####...###.........../
/.............................................#.....#..##............/
/............................................#.......###............./
/...........................................#........###............./
/............................................#.......###............./
/.............................................#.....#...#............/
/..............................................#####.....#.........../
/.........................................................#........../
/.........................................................###########/
/..................................................................../
//////////////////////////////////////////////////////////////////////
